NO ./tests/textures/north_texture.xpm
SO ./tests/textures/south_texture.xpm
EA ./tests/textures/east_texture.xpm
WE ./tests/textures/west_texture.xpm
F 42, 55, 57
C 255, 255, 255

11111111111111111111111111
10000000000000000000000001
10001110000000001000000001
10001110011111101000011001
10000000010000001000011001
11001000011111111000000001
10011100000000001011111001
10001000000000000000001001
11111111111111111111111111
