NO ./tests/textures/north_texture.xpm
SO ./tests/textures/south_texture.xpm
EA ./tests/textures/east_texture.xpm
WE ./tests/textures/west_texture.xpm
F 42, 55, 57
C 255, 255, 255

                      1111111111111111
                      1001111111111001
                      1001000000001001
                      1001000000001001
                      1001000000001001
                      1001000000001001
11111111111111        1001111111111001
10000000000001        1000000000000001
10000000000001        1000000000000001
10011000011001        1000000000000001
10011000011001        1000000000000001
10011000011001        1000000000000001
10011000011001        1000000000000001
10000000000001        1000000000000001  111
100000000000011111111110000000000000011110111111111111111
100001111000001000000010000000000000000000000000000000001
100001111000000001000000000000000000000000000000000000001
100001111000011111111110000000000000011000111111111100001
10000000000001        10000000000000011000100000000100001
10000000000001        10000000000000011000100000000100001
10011000011001        10000000000000011000100000000100001
10011000011001        10000000000000011000100000000100001
10011000011001        10000000000000011000111111111100001
10011000011001        10000000000000011000000000000000001
10000000000001        10001110011100011000000000000000001
10000000000001        10001000000100011000111111111100001
11111111111111        10001000000100011000100000000100001
                      10000000000000011000100000000100001
                      10000000000000011000100000000100001
                      10001000000100011000100000000100001
                      10001000000100011000111111111100001
                      10001110011100011000000000000000001
                      10000000000000011000000000000000001
                      10000000000000011111111111111111111
                      1000000000000001
                      1000000000000001
    11111111111111111110000000000000011111111111111111111111
111110001110011100111000000000000000001000000000000000000001
100000100000000000000000000000000000000000000000000000000001
100000100000000000000000000000000000000000000000000000000001
111110001110011100111000001111111000001111100111110011110011
    11111111111111111111111111111111111111111111111111111111
