NO ./textures/north_texture.xpm
SO ./textures/south_texture.xpm
EA ./textures/east_texture.xpm
WE ./textures/west_texture.xpm
C 255, 255, 255

11111111111111
10000000000001
11111111111111
