NO ./textures/north_texture.xpm
SO ./textures/south_texture.xpm
EA ./textures/east_texture.xpm
WE ./textures/west_texture.xpm
F 42, 55, 57
C 255, 255, 255
WE ./textures/west_texture.xpm

11111111111111111
10000000000000001
10000000000000001
10000000000000001
10000000000000001
10000000000000001
11111111111111111
