NO ./assets/textures/north_texture.xpm
SO ./assets/textures/south_texture.xpm
EA ./assets/textures/east_texture.xpm
WE ./assets/textures/west_texture.xpm
F 42, 55, 57
C 255, 255, 255

   1111111            11111    11111    11111    11111
   100E001            10001    10001    10001    10001
  1100000111        1110001    10001    10001    10001
11100000000111    111000001111110001111110001111110001
100000000000011111100000000000000000000000000000000001
111111111110000000000000000000000000000000000000000001
          11111000001111111111111111111111111111111111
              1000001
              1111111