NO ./assets/textures/north_texture.xpm
SO ./assets/textures/south_texture.xpm
EA ./assets/textures/east_texture.xpm
WE ./assets/textures/west_texture.xpm
F 42, 55, 57
C 255, 255, 255

   1111111            11111    11111111111111    11111
   1000001            10001    10000000000001    10001    111111111
  1100000111        1110001    10000000000001    10001    100000001
11100000000111    11100000111111000011110000111111000111  100000E01
1000000000000111111000000000000000001  100000000000000011 100000001
1111111111100000000000000000000000001  1000000000000000011100000001
          111110000011111111111111111  1111111111111110000000011111
              1000001                                1001111111
              1111111                                1111