NO ./assets/textures/eagle.xpm
SO ./assets/textures/redbrick.xpm
EA ./assets/textures/purplestone.xpm
WE ./assets/textures/greystone.xpm
F 89, 65, 169
C 29, 17, 40

111111111111111111111111
100000000000000010000001
101000000000000000000001
10100000N000000000000001
101000000000000010000001
101000011111111111011111
101000010101010110001111
101000010000000110000001
101000000000000000001111
101000010000000110000001
100000010000000110001111
100000011110111111111111
101111111110111111111111
100000000000000000000001
101111011110111111111111
101111011110111111111111
100000000110110000010001
100000000000110010010001
100000000110110000011011
101010000110000010000001
100100000110110000011011
101010000110110010010001
100000000000000000000001
111111111111111111111111