NO ./assets/textures/north_texture_monochrome.xpm
SO ./assets/textures/south_texture_monochrome.xpm
EA ./assets/textures/east_texture_monochrome.xpm
WE ./assets/textures/west_texture_monochrome.xpm
F 255, 163, 165
C 255, 191, 129

1111111111111
10N0000000001
1000000000001
1000000000001
1000000000001
1000000000001
1111111111111