NO ./assets/textures/bluestone.xpm
SO ./assets/textures/redbrick.xpm
EA ./assets/textures/purplestone.xpm
WE ./assets/textures/greystone.xpm
F 89, 65, 169
C 29, 17, 40

1111111111111111
1000000000E00001
1000001000000001
1000001000000001
1000001010000001
1000000010000001
1000000000000001
1111111111111111