NO ./textures/north_texture.xpm
SO ./textures/south_texture.xpm
EA ./textures/east_texture.xpm
WE ./textures/west_texture.xpm
F 255,255,255
C 42, 42, 42

11111111111
10000000001
100000E0001
10000000001
11111111111
